NO ./textures/north.xpm
SO ./textures/south.xpm
WE ./textures/west.xpm
EA ./textures/east.xpm
F   100, +100, 100
C       0, 0, 0


111111111111111111111111
100000000000000000000001
100000000000000000000001
100000000000000000000001
10000000000S000000000001
111111111111111111111111        